1;1;1;1;1;1;1;1;1;1;1;1;1;1;1;1;1;1;1;1;1;1;1;1;1;1;1;1
1;3;2;2;2;2;2;2;2;2;2;2;2;1;1;2;2;2;2;2;2;2;2;2;2;2;3;1
1;2;1;1;1;1;2;1;1;1;1;1;2;1;1;2;1;1;1;1;1;2;1;1;1;1;2;1
1;2;1;1;1;1;2;1;1;1;1;1;2;1;1;2;1;1;1;1;1;2;1;1;1;1;2;1
1;2;2;2;2;2;2;2;2;2;2;2;2;2;2;2;2;2;2;2;2;2;2;2;2;2;2;1
1;2;1;1;1;1;2;1;1;2;1;1;1;1;1;1;1;1;2;1;1;2;1;1;1;1;2;1
1;2;2;2;2;1;2;1;1;2;2;2;2;1;1;2;2;2;2;1;1;2;1;2;2;2;2;1
1;1;1;1;2;1;2;1;1;1;1;1;2;1;1;2;1;1;1;1;1;2;1;2;1;1;1;1
1;0;0;1;2;1;2;2;2;2;2;2;2;2;2;2;2;2;2;2;2;2;1;2;1;0;0;1
1;1;1;1;2;1;1;1;1;2;1;1;1;0;0;1;1;1;2;1;1;1;1;2;1;1;1;1
0;0;0;0;2;2;2;2;1;2;1;0;0;0;0;0;0;1;2;1;2;2;2;2;0;0;0;0
1;1;1;1;2;1;1;2;1;2;1;0;4;4;4;4;0;1;2;1;2;1;1;2;1;1;1;1
1;1;1;1;2;1;1;2;1;2;1;0;4;4;4;4;0;1;2;1;2;1;1;2;1;1;1;1
7;2;2;2;2;1;1;2;2;2;0;0;4;5;4;4;0;0;2;2;2;1;1;2;2;2;2;7
1;1;1;1;2;1;1;2;1;2;1;0;4;4;4;4;0;1;2;1;2;1;1;2;1;1;1;1
1;1;1;1;2;1;1;2;1;2;1;0;0;0;0;0;0;1;2;1;2;1;1;2;1;1;1;1
0;0;0;0;2;2;2;2;1;2;1;1;1;1;1;1;1;1;2;1;2;2;2;2;0;0;0;0
1;1;1;1;2;1;1;1;1;2;2;2;2;1;1;2;2;2;2;1;1;1;1;2;1;1;1;1
1;0;0;1;2;1;2;2;2;2;2;2;2;1;1;2;2;2;2;2;2;2;1;2;1;0;0;1
1;1;1;1;2;1;2;1;1;1;1;1;2;1;1;2;1;1;1;1;1;2;1;2;1;1;1;1
1;2;2;2;2;1;2;1;1;2;2;2;2;2;2;2;2;2;2;1;1;2;1;2;2;2;2;1
1;2;1;1;1;1;2;1;1;2;1;1;1;1;1;1;1;1;2;1;1;2;1;1;1;1;2;1
1;2;2;2;2;2;2;2;2;2;2;2;2;1;1;2;2;2;2;2;2;2;2;2;2;2;2;1
1;2;1;1;1;1;2;1;1;1;1;1;2;1;1;2;1;1;1;1;1;2;1;1;1;1;2;1
1;2;1;1;1;1;2;1;1;1;1;1;2;1;1;2;1;1;1;1;1;2;1;1;1;1;2;1
1;3;2;2;2;2;2;2;2;2;2;2;2;2;2;2;2;2;2;2;2;2;2;2;2;2;3;1
1;1;1;1;1;1;1;1;1;1;1;1;1;1;1;1;1;1;1;1;1;1;1;1;1;1;1;1
1;1;1;1;1;1;1;1;1;1;1;1;1;1;1;1;1;1;1;1;1;1;1;1;1;1;1;1
1;1;1;1;1;1;1;1;1;1;1;1;1;1;1;1;1;1;1;1;1;1;1;1;1;1;1;1
1;1;1;1;1;1;1;1;1;1;1;1;1;1;1;1;1;1;1;1;1;1;1;1;1;1;1;1
1;1;1;1;1;1;1;1;1;1;1;1;1;1;1;1;1;1;1;1;1;1;1;1;1;1;1;1
1;1;1;1;1;1;1;1;1;0;1;1;1;1;0;1;1;1;1;1;1;1;1;1;1;1;1;1
1;1;1;1;1;1;1;1;1;1;1;1;1;1;1;1;1;1;1;1;1;1;1;1;1;1;1;1
1;1;1;1;1;1;1;1;1;1;0;1;1;1;1;1;1;1;1;1;1;1;1;1;1;1;1;1
1;1;1;1;1;1;1;1;1;1;1;0;0;0;1;1;1;1;1;1;1;1;1;1;1;1;1;1
1;1;1;1;1;1;1;1;1;1;1;1;1;1;1;1;1;1;1;1;1;1;1;1;1;1;1;1
